0  0  0  0  0  0  0  0  0  0  0  0  0  0  0  0  0  0  0  0  0  0  0  0  0  0  0  0  0  0  0  0  0  0  0  0  0  0  0  0  0  0  0  0  0  0  0  0  0  0  0  0  0  0  0  0  0  0  0  0  0  0  0  0  0  0  0  0  0  0  0  0  0  0  0  
0  0  0  0  0  0  0  0  0  0  0  0  0  0  0  0  0  0  0  0  0  0  0  0  0  0  0  0  0  0  0  0  0  0  0  0  0  0  0  0  0  0  0  0  0  0  0  0  0  0  0  0  0  0  0  0  0  0  0  0  0  0  0  0  0  0  0  0  0  0  0  0  0  0  0  
0  0  0  0  0  0  0  0  0  0  0  0  0  0  0  0  0  0  0  0  0  0  0  0  0  0  0  0  0  0  0  0  0  0  0  0  0  0  0  0  0  0  0  0  0  0  0  0  0  0  0  0  0  0  0  0  0  0  0  0  0  0  0  0  0  0  0  0  0  0  0  0  0  0  0  
0  0  0  0  0  0  0  0  0  0  0  0  0  0  0  0  0  0  0  0  0  0  0  0  0  0  0  0  0  0  0  0  0  0  0  0  0  0  0  0  0  0  0  0  0  0  0  0  0  0  0  0  0  0  0  0  0  0  0  0  0  0  0  0  0  0  0  0  0  0  0  0  0  0  0  
0  0  0  0  0  0  0  0  0  0  0  0  0  0  0  0  0  0  0  0  0  0  0  0  0  0  0  0  0  0  0  0  0  0  0  0  0  0  0  0  0  0  0  0  0  0  0  0  0  0  0  0  0  0  0  0  0  0  0  0  0  0  0  0  0  0  0  0  0  0  0  0  0  0  0  
0  0  0  0  0  0  0  0  0  0  0  0  0  0  0  0  0  0  0  0  0  0  0  0  0  0  0  0  0  0  0  0  0  0  0  0  0  0  0  0  0  0  0  0  0  0  0  0  0  0  0  0  0  0  0  0  0  0  0  0  0  0  0  0  0  0  0  0  0  0  0  0  0  0  0  
0  0  0  0  0  0  0  0  0  0  0  0  0  0  0  0  0  0  0  0  0  0  0  0  0  0  0  0  0  0  0  0  0  0  0  0  0  0  0  0  0  0  0  0  0  0  0  0  0  0  0  0  0  0  0  0  0  0  0  0  0  0  0  0  0  0  0  0  0  0  0  0  0  0  0  
0  0  0  0  0  0  0  0  0  0  0  0  0  0  0  0  0  0  0  0  0  0  0  0  0  0  0  0  0  0  0  0  0  0  0  0  0  0  0  0  0  0  0  0  0  0  0  0  0  0  0  0  0  0  0  0  0  0  0  0  0  0  0  0  0  0  0  0  0  0  0  0  0  0  0  
0  0  1  2  2  2  2  2  2  2  2  2  3  0  0  0  0  1  2  2  2  2  2  2  2  2  2  3  0  0  0  0  1  2  2  2  2  2  2  2  2  2  3  0  0  0  0  1  2  2  2  2  2  2  2  2  2  3  0  0  0  0  1  2  2  2  2  2  2  2  2  2  3  0  0  
0  0  6  5  5  5  5  5  5  5  5  5  6  0  0  0  0  6  5  5  5  5  5  5  5  5  5  6  0  0  0  0  6  5  5  5  5  5  5  5  5  5  6  0  0  0  0  6  5  5  5  5  5  5  5  5  5  6  0  0  0  0  6  5  5  5  5  5  5  5  5  5  6  0  0  
0  0  6  5  5  5  5  5  5  5  5  5  6  0  0  0  0  6  5  5  5  5  5  5  5  5  5  6  0  0  0  0  6  5  5  5  5  5  5  5  5  5  6  0  0  0  0  6  5  5  5  5  5  5  5  5  5  6  0  0  0  0  6  5  5  5  5  5  5  5  5  5  6  0  0  
0  0  6  5  5  5  5  5  5  5  5  5  7  2  2  2  2  9  5  5  5  5  5  5  5  5  5  7  2  2  2  2  9  5  5  5  5  5  5  5  5  5  7  2  2  2  2  9  5  5  5  5  5  5  5  5  5  7  2  2  2  2  9  5  5  5  5  5  5  5  5  5  6  0  0  
0  0  6  5  5  5  5  5  5  5  5  5  5  5  5  5  5  5  5  5  5  5  5  5  5  5  5  5  5  5  5  5  5  5  5  5  5  5  5  5  5  5  5  5  5  5  5  5  5  5  5  5  5  5  5  5  5  5  5  5  5  5  5  5  5  5  5  5  5  5  5  5  6  0  0  
0  0  6  5  5  5  5  5  5  5  5  5  5  5  5  5  5  5  5  5  5  5  5  5  5  5  5  5  5  5  5  5  5  5  5  5  5  5  5  5  5  5  5  5  5  5  5  5  5  5  5  5  5  5  5  5  5  5  5  5  5  5  5  5  5  5  5  5  5  5  5  5  6  0  0  
0  0  6  5  5  5  5  5  5  5  5  5  5  5  5  5  5  5  5  5  5  5  5  5  5  5  5  5  5  5  5  5  5  5  5  5  5  5  5  5  5  5  5  5  5  5  5  5  5  5  5  5  5  5  5  5  5  5  5  5  5  5  5  5  5  5  5  5  5  5  5  5  6  0  0  
0  0  6  5  5  5  5  5  5  5  5  5  1  2  2  2  2  3  5  5  5  5  5  5  5  5  5  1  2  2  2  2  3  5  5  5  5  5  5  5  5  5  1  2  2  2  2  3  5  5  5  5  5  5  5  5  5  1  2  2  2  2  3  5  5  5  5  5  5  5  5  5  6  0  0  
0  0  6  5  5  5  5  5  5  5  5  5  6  0  0  0  0  6  5  5  5  5  5  5  5  5  5  6  0  0  0  0  6  5  5  5  5  5  5  5  5  5  6  0  0  0  0  6  5  5  5  5  5  5  5  5  5  6  0  0  0  0  6  5  5  5  5  5  5  5  5  5  6  0  0  
0  0  6  5  5  5  5  5  5  5  5  5  6  0  0  0  0  6  5  5  5  5  5  5  5  5  5  6  0  0  0  0  6  5  5  5  5  5  5  5  5  5  6  0  0  0  0  6  5  5  5  5  5  5  5  5  5  6  0  0  0  0  6  5  5  5  5  5  5  5  5  5  6  0  0  
0  0  7  2  2  2  2  2  2  2  2  2  9  0  0  0  0  7  2  2  2  2  2  2  2  2  2  9  0  0  0  0  7  2  2  2  2  2  2  2  2  2  9  0  0  0  0  7  2  2  2  2  2  2  2  2  2  9  0  0  0  0  7  2  2  2  2  2  2  2  2  2  9  0  0  
0  0  0  0  0  0  0  0  0  0  0  0  0  0  0  0  0  0  0  0  0  0  0  0  0  0  0  0  0  0  0  0  0  0  0  0  0  0  0  0  0  0  0  0  0  0  0  0  0  0  0  0  0  0  0  0  0  0  0  0  0  0  0  0  0  0  0  0  0  0  0  0  0  0  0  
0  0  0  0  0  0  0  0  0  0  0  0  0  0  0  0  0  0  0  0  0  0  0  0  0  0  0  0  0  0  0  0  0  0  0  0  0  0  0  0  0  0  0  0  0  0  0  0  0  0  0  0  0  0  0  0  0  0  0  0  0  0  0  0  0  0  0  0  0  0  0  0  0  0  0  
0  0  0  0  0  0  0  0  0  0  0  0  0  0  0  0  0  0  0  0  0  0  0  0  0  0  0  0  0  0  0  0  0  0  0  0  0  0  0  0  0  0  0  0  0  0  0  0  0  0  0  0  0  0  0  0  0  0  0  0  0  0  0  0  0  0  0  0  0  0  0  0  0  0  0  
0  0  0  0  0  0  0  0  0  0  0  0  0  0  0  0  0  0  0  0  0  0  0  0  0  0  0  0  0  0  0  0  0  0  0  0  0  0  0  0  0  0  0  0  0  0  0  0  0  0  0  0  0  0  0  0  0  0  0  0  0  0  0  0  0  0  0  0  0  0  0  0  0  0  0  
0  0  0  0  0  0  0  0  0  0  0  0  0  0  0  0  0  0  0  0  0  0  0  0  0  0  0  0  0  0  0  0  0  0  0  0  0  0  0  0  0  0  0  0  0  0  0  0  0  0  0  0  0  0  0  0  0  0  0  0  0  0  0  0  0  0  0  0  0  0  0  0  0  0  0  
0  0  1  2  2  2  2  2  2  2  2  2  3  0  0  0  0  1  2  2  2  2  2  2  2  2  2  3  0  0  0  0  1  2  2  2  2  2  2  2  2  2  3  0  0  0  0  1  2  2  2  2  2  2  2  2  2  3  0  0  0  0  1  2  2  2  2  2  2  2  2  2  3  0  0  
0  0  6  5  5  5  5  5  5  5  5  5  6  0  0  0  0  6  5  5  5  5  5  5  5  5  5  6  0  0  0  0  6  5  5  5  5  5  5  5  5  5  6  0  0  0  0  6  5  5  5  5  5  5  5  5  5  6  0  0  0  0  6  5  5  5  5  5  5  5  5  5  6  0  0  
0  0  6  5  5  5  5  5  5  5  5  5  6  0  0  0  0  6  5  5  5  5  5  5  5  5  5  6  0  0  0  0  6  5  5  5  5  5  5  5  5  5  6  0  0  0  0  6  5  5  5  5  5  5  5  5  5  6  0  0  0  0  6  5  5  5  5  5  5  5  5  5  6  0  0  
0  0  6  5  5  5  5  5  5  5  5  5  7  2  2  2  2  9  5  5  5  5  5  5  5  5  5  7  2  2  2  2  9  5  5  5  5  5  5  5  5  5  7  2  2  2  2  9  5  5  5  5  5  5  5  5  5  7  2  2  2  2  9  5  5  5  5  5  5  5  5  5  6  0  0  
0  0  6  5  5  5  5  5  5  5  5  5  5  5  5  5  5  5  5  5  5  5  5  5  5  5  5  5  5  5  5  5  5  5  5  5  5  5  5  5  5  5  5  5  5  5  5  5  5  5  5  5  5  5  5  5  5  5  5  5  5  5  5  5  5  5  5  5  5  5  5  5  6  0  0  
0  0  6  5  5  5  5  5  5  5  5  5  5  5  5  5  5  5  5  5  5  5  5  5  5  5  5  5  5  5  5  5  5  5  5  5  5  5  5  5  5  5  5  5  5  5  5  5  5  5  5  5  5  5  5  5  5  5  5  5  5  5  5  5  5  5  5  5  5  5  5  5  6  0  0  
0  0  6  5  5  5  5  5  5  5  5  5  5  5  5  5  5  5  5  5  5  5  5  5  5  5  5  5  5  5  5  5  5  5  5  5  5  5  5  5  5  5  5  5  5  5  5  5  5  5  5  5  5  5  5  5  5  5  5  5  5  5  5  5  5  5  5  5  5  5  5  5  6  0  0  
0  0  6  5  5  5  5  5  5  5  5  5  1  2  2  2  2  3  5  5  5  5  5  5  5  5  5  1  2  2  2  2  3  5  5  5  5  5  5  5  5  5  1  2  2  2  2  3  5  5  5  5  5  5  5  5  5  1  2  2  2  2  3  5  5  5  5  5  5  5  5  5  6  0  0  
0  0  6  5  5  5  5  5  5  5  5  5  6  0  0  0  0  6  5  5  5  5  5  5  5  5  5  6  0  0  0  0  6  5  5  5  5  5  5  5  5  5  6  0  0  0  0  6  5  5  5  5  5  5  5  5  5  6  0  0  0  0  6  5  5  5  5  5  5  5  5  5  6  0  0  
0  0  6  5  5  5  5  5  5  5  5  5  6  0  0  0  0  6  5  5  5  5  5  5  5  5  5  6  0  0  0  0  6  5  5  5  5  5  5  5  5  5  6  0  0  0  0  6  5  5  5  5  5  5  5  5  5  6  0  0  0  0  6  5  5  5  5  5  5  5  5  5  6  0  0  
0  0  7  2  2  2  2  2  2  2  2  2  9  0  0  0  0  7  2  2  2  2  2  2  2  2  2  9  0  0  0  0  7  2  2  2  2  2  2  2  2  2  9  0  0  0  0  7  2  2  2  2  2  2  2  2  2  9  0  0  0  0  7  2  2  2  2  2  2  2  2  2  9  0  0  
0  0  0  0  0  0  0  0  0  0  0  0  0  0  0  0  0  0  0  0  0  0  0  0  0  0  0  0  0  0  0  0  0  0  0  0  0  0  0  0  0  0  0  0  0  0  0  0  0  0  0  0  0  0  0  0  0  0  0  0  0  0  0  0  0  0  0  0  0  0  0  0  0  0  0  
0  0  0  0  0  0  0  0  0  0  0  0  0  0  0  0  0  0  0  0  0  0  0  0  0  0  0  0  0  0  0  0  0  0  0  0  0  0  0  0  0  0  0  0  0  0  0  0  0  0  0  0  0  0  0  0  0  0  0  0  0  0  0  0  0  0  0  0  0  0  0  0  0  0  0  
0  0  0  0  0  0  0  0  0  0  0  0  0  0  0  0  0  0  0  0  0  0  0  0  0  0  0  0  0  0  0  0  0  0  0  0  0  0  0  0  0  0  0  0  0  0  0  0  0  0  0  0  0  0  0  0  0  0  0  0  0  0  0  0  0  0  0  0  0  0  0  0  0  0  0  
0  0  0  0  0  0  0  0  0  0  0  0  0  0  0  0  0  0  0  0  0  0  0  0  0  0  0  0  0  0  0  0  0  0  0  0  0  0  0  0  0  0  0  0  0  0  0  0  0  0  0  0  0  0  0  0  0  0  0  0  0  0  0  0  0  0  0  0  0  0  0  0  0  0  0  
0  0  0  0  0  0  0  0  0  0  0  0  0  0  0  0  0  0  0  0  0  0  0  0  0  0  0  0  0  0  0  0  0  0  0  0  0  0  0  0  0  0  0  0  0  0  0  0  0  0  0  0  0  0  0  0  0  0  0  0  0  0  0  0  0  0  0  0  0  0  0  0  0  0  0  
0  0  0  0  0  0  0  0  0  0  0  0  0  0  0  0  0  0  0  0  0  0  0  0  0  0  0  0  0  0  0  0  0  0  0  0  0  0  0  0  0  0  0  0  0  0  0  0  0  0  0  0  0  0  0  0  0  0  0  0  0  0  0  0  0  0  0  0  0  0  0  0  0  0  0  
0  0  0  0  0  0  0  0  0  0  0  0  0  0  0  0  0  0  0  0  0  0  0  0  0  0  0  0  0  0  0  0  0  0  0  0  0  0  0  0  0  0  0  0  0  0  0  0  0  0  0  0  0  0  0  0  0  0  0  0  0  0  0  0  0  0  0  0  0  0  0  0  0  0  0  
0  0  0  0  0  0  0  0  0  0  0  0  0  0  0  0  0  0  0  0  0  0  0  0  0  0  0  0  0  0  0  0  0  0  0  0  0  0  0  0  0  0  0  0  0  0  0  0  0  0  0  0  0  0  0  0  0  0  0  0  0  0  0  0  0  0  0  0  0  0  0  0  0  0  0  
0  0  0  0  0  0  0  0  0  0  0  0  0  0  0  0  0  0  0  0  0  0  0  0  0  0  0  0  0  0  0  0  0  0  0  0  0  0  0  0  0  0  0  0  0  0  0  0  0  0  0  0  0  0  0  0  0  0  0  0  0  0  0  0  0  0  0  0  0  0  0  0  0  0  0  
0  0  0  0  0  0  0  0  0  0  0  0  0  0  0  0  0  0  0  0  0  0  0  0  0  0  0  0  0  0  0  0  0  0  0  0  0  0  0  0  0  0  0  0  0  0  0  0  0  0  0  0  0  0  0  0  0  0  0  0  0  0  0  0  0  0  0  0  0  0  0  0  0  0  0  
